<6><6><6><6><6><6><6><6><6><6><6><6><6><1><6><6><6><6><6><6><1><6><6><6><6><6><6><6><6><6><6><6><6><6><6>
<1><1><6><6><6><6><6><6><6><6><6><6><6><6><1><1><1><1><1><1><1><6><6><6><6><6><6><6><6><6><6><6><6><6><1>
<1><1><6><6><6><1><1><1><6><6><1><1><1><6><6><6><6><1><1><6><6><6><6><6><6><6><6><6><6><6><6><6><6><1><1>
<10><0><11><6><6><10><0><11><1><1><10><0><11><1><6><6><6><6><6><6><6><6><6><6><1><1><6><6><6><1><1><1><10><0><0>
<0><0><0><11><10><0><0><0><0><0><0><0><0><1><6><6><6><6><6><6><6><1><10><0><0><11><1><1><1><10><0><0><0><0><0>
<0><0><0><0><0><0><0><0><0><0><0><0><0><11><1><1><1><1><1><1><10><0><0><0><0><0><0><0><0><0><0><0><0><0><0>
<0><0><0><0><0><0><0><0><0><0><0><0><0><0><11><10><0><0><0><0><0><0><0><0><0><0><0><0><0><0><0><0><0><0><0>
<0><0><0><0><0><0><0><0><0><0><0><0><0><0><0><0><0><0><0><0><0><0><0><0><0><0><0><0><0><0><0><0><0><0><0>
<0><0><0><0><0><0><0><0><0><0><0><0><0><0><0><0><0><0><0><0><0><0><0><0><0><0><0><0><0><0><0><0><0><0><0>
<0><0><0><0><0><0><0><0><0><0><0><0><0><0><0><0><0><0><0><0><0><0><0><0><0><0><0><0><0><0><0><0><0><0><0>
<0><0><0><0><0><0><0><0><0><0><0><0><0><0><0><0><0><0><0><0><0><0><0><0><0><0><0><0><0><0><0><0><0><0><0>
<0><0><0><0><0><0><0><0><0><0><0><0><0><0><0><0><0><0><0><0><0><0><0><0><0><0><0><0><0><0><0><0><0><0><0>
<0><0><0><0><0><0><0><0><0><0><0><0><0><0><0><0><0><0><0><0><0><0><0><0><0><0><0><0><0><0><0><0><0><0><0>
<0><0><0><0><0><0><0><0><0><0><0><0><0><0><0><0><0><0><0><0><0><0><0><0><0><0><0><0><0><0><0><0><0><0><0>
<0><0><0><0><0><0><0><0><0><0><0><0><0><0><0><0><0><0><0><0><0><0><0><0><0><0><0><0><0><0><0><0><0><0><0>
<0><0><0><0><0><0><0><0><0><0><0><0><0><0><0><0><0><0><0><0><0><0><0><0><0><0><0><0><0><0><0><0><0><0><0>
<0><0><0><0><0><0><0><0><0><0><0><0><0><0><0><0><0><0><0><0><0><0><0><0><0><0><0><0><0><0><0><0><0><0><0>
<0><0><0><0><0><0><0><0><0><0><0><0><0><0><0><0><0><0><0><0><0><0><0><0><0><0><0><0><0><0><0><0><0><0><0>
<0><0><0><0><0><0><0><0><0><0><0><0><0><0><0><0><0><0><0><0><0><0><0><0><0><0><0><0><0><0><0><0><0><0><0>
<0><0><0><0><0><0><0><0><0><0><0><0><0><0><0><0><0><0><0><0><0><0><0><0><0><0><0><0><0><0><0><0><0><0><0>
<0><0><0><0><0><0><0><0><0><0><0><0><0><0><0><0><0><0><0><0><0><0><0><0><0><0><0><0><0><0><0><0><0><0><0>
<0><0><0><0><0><0><0><0><0><0><0><0><0><0><0><0><0><0><0><0><0><0><0><0><0><0><0><0><0><0><0><0><0><0><0>
<0><0><0><0><0><0><0><0><0><0><0><0><0><0><0><0><0><0><0><0><0><0><0><0><0><0><0><0><0><0><0><0><0><0><0>
<0><0><0><0><0><0><0><0><0><0><0><0><0><0><0><0><0><0><0><0><0><0><0><0><0><0><0><0><0><0><0><0><0><0><0>
<0><0><0><0><0><0><0><0><0><0><0><0><0><0><0><0><0><0><0><0><0><0><0><0><0><0><0><0><0><0><0><0><0><0><0>
<1><1><1><8><0><0><0><0><0><0><0><0><0><0><0><0><0><0><9><6><6><6><8><0><0><0><0><0><0><0><0><0><0><0><0>
<6><6><6><6><8><0><0><0><0><0><0><0><0><0><9><6><6><6><6><6><6><6><6><6><6><6><6><6><8><0><0><0><0><0><0>
<6><6><6><6><6><1><1><1><1><1><1><6><6><6><6><6><6><6><6><6><1><6><6><6><1><6><6><1><6><6><6><1><1><1><1>
<!bg=DEFAULT>