<1><1><1><1><1><1><1><1><1><1><1><1><1><1><1><1><1><1><1><1><1><1><1><1><1><1><1><1><1><1><1><1><1><1><1>
<1><10><0><0><0><11><10><0><11><1><1><1><1><1><0><0><0><0><0><11><1><1><0><0><0><0><11><1><1><1><1><1><10><0><0>
<10><0><0><0><0><0><0><0><0><11><1><1><1><10><0><0><0><0><0><0><0><0><0><0><0><0><0><0><0><0><0><0><0><0><0>
<0><0><0><0><0><0><0><0><0><0><11><1><10><0><0><0><0><0><0><0><0><0><0><0><0><0><0><0><0><0><0><0><0><0><0>
<0><0><0><0><0><0><0><0><0><0><0><0><0><0><0><0><0><0><0><0><0><0><0><0><0><0><0><0><0><0><0><0><0><0><0>
<0><0><0><0><0><0><0><0><0><0><0><0><0><0><0><0><0><0><0><0><0><0><0><0><0><0><0><0><0><0><0><0><0><0><0>
<0><0><0><0><0><0><0><0><0><0><0><0><0><0><0><0><0><0><0><0><0><0><0><0><0><0><0><0><0><0><0><0><0><0><0>
<0><0><0><0><0><0><0><0><0><0><0><0><0><0><0><0><0><0><0><0><0><0><0><0><0><0><0><0><0><0><0><0><0><0><0>
<0><0><0><0><0><0><0><0><0><0><0><0><0><0><0><0><0><0><0><0><0><0><0><0><0><0><0><0><0><0><0><0><0><0><0>
<0><0><0><0><0><0><0><0><0><0><0><0><0><0><0><0><0><0><0><0><0><0><0><0><0><0><0><0><0><0><0><0><0><0><0>
<0><0><0><0><0><0><0><0><0><0><0><0><0><0><0><0><0><0><0><0><0><0><0><0><0><0><0><0><0><0><0><0><0><0><0>
<0><0><0><0><0><0><0><0><0><0><0><0><0><0><0><0><0><0><0><0><0><0><0><0><0><0><0><0><0><0><0><0><0><0><0>
<0><0><0><0><0><0><0><0><0><0><0><0><0><0><0><0><0><0><0><0><0><0><0><0><0><0><0><0><0><0><0><0><0><0><0>
<0><0><0><0><0><0><0><0><0><0><0><0><0><0><0><0><0><0><0><0><0><0><0><0><0><0><0><0><0><0><0><0><0><0><0>
<0><0><0><0><0><0><0><0><0><0><0><0><0><0><0><0><0><0><0><0><0><0><0><0><0><0><0><0><0><0><0><0><0><0><0>
<0><0><0><0><0><0><0><0><0><0><0><0><0><0><0><0><0><0><0><0><0><0><0><0><0><0><0><0><0><0><0><0><0><0><0>
<0><0><0><0><0><0><0><0><0><0><0><0><0><0><0><0><0><0><0><0><0><0><0><0><0><0><0><0><0><0><0><0><0><0><0>
<0><0><0><0><0><0><0><0><0><0><0><0><0><0><0><0><0><0><0><0><0><0><0><0><0><0><0><0><0><0><0><0><0><0><0>
<0><0><0><0><0><0><0><0><0><0><0><0><0><0><0><0><0><0><0><0><0><0><0><0><0><9><1><1><2><2><2><2><2><2><1>
<0><0><0><0><0><0><0><0><0><0><0><0><0><0><0><0><0><0><0><0><0><0><0><0><9><1><1><6><1><2><2><2><2><1><1>
<0><0><0><0><0><0><0><0><0><0><0><0><0><0><0><3><1><1><1><1><1><1><1><1><6><1><1><6><6><1><1><1><1><6><7>
<0><0><0><0><0><0><0><0><0><0><0><0><0><0><3><6><6><6><6><6><1><6><6><6><6><6><1><1><1><7><1><1><6><6><1>
<0><0><0><0><0><0><0><0><0><0><0><0><0><3><6><6><1><6><1><1><1><1><1><1><7><1><1><1><1><1><1><6><7><1><1>
<1><0><0><0><0><0><0><0><0><0><0><0><3><6><1><1><1><1><1><7><1><6><6><6><6><1><6><6><1><1><1><1><1><1><1>
<1><0><0><0><0><0><0><0><0><0><0><3><6><1><1><1><6><1><6><6><1><6><1><1><1><1><7><6><6><6><1><1><1><1><1>
<0><0><0><0><0><0><0><0><0><0><3><6><6><1><1><1><6><1><6><1><1><7><1><1><1><1><1><6><6><6><1><1><6><6><1>
<0><0><0><0><0><0><0><0><0><3><6><1><1><1><1><1><7><1><1><1><1><1><1><1><1><1><1><6><6><6><1><6><1><1><1>
<1><1><1><1><1><1><1><1><1><6><6><1><1><1><1><1><1><6><6><1><1><1><1><1><1><1><1><1><1><6><6><6><6><1><6>
<!bg=CROWN>
<!d=1>