<0><0><0><0><0><0><0><0><0><0><0><0><0><0><0><0><0><0><0><0><0><0><0><0><0><0><0><0><0><0><0><0><0><0><0>
<0><0><0><0><0><0><0><0><0><0><0><0><0><0><0><0><0><0><0><0><7><0><7><0><0><0><0><0><0><7><0><7><0><0><0>
<0><0><0><0><0><0><0><0><0><0><0><0><0><0><0><0><0><0><0><0><7><0><7><0><0><0><0><0><0><0><0><7><0><0><0>
<0><0><0><0><0><0><0><0><0><0><0><0><0><0><0><0><0><0><0><0><7><7><7><0><7><7><7><0><0><7><0><7><0><0><0>
<0><0><0><0><0><0><0><0><0><0><0><0><0><0><0><0><0><0><0><0><7><0><7><0><7><0><7><0><0><7><0><7><0><0><0>
<0><0><0><0><0><0><0><0><0><0><0><0><0><0><0><0><0><0><0><0><7><0><7><0><7><7><7><7><0><7><0><7><0><0><0>
<0><0><0><0><0><0><0><0><0><0><0><0><0><0><0><0><0><0><0><0><0><0><0><0><0><0><0><0><0><0><0><0><0><0><0>
<0><0><0><0><0><0><0><0><0><0><0><0><0><0><0><0><0><0><0><0><0><0><0><0><7><7><0><0><7><7><7><0><7><7><7>
<0><0><0><0><0><0><0><0><0><0><0><0><0><0><0><0><0><0><0><0><0><0><0><0><7><0><7><0><7><0><0><0><7><0><0>
<0><0><0><0><0><0><0><0><0><0><0><0><0><0><0><0><0><0><0><0><0><0><0><0><7><7><0><0><7><7><0><0><7><7><0>
<0><0><0><0><0><0><0><0><0><0><0><0><0><0><0><0><0><0><0><0><0><0><0><0><7><0><7><0><7><0><0><0><7><0><0>
<0><0><0><0><0><0><0><0><0><0><0><0><0><0><0><0><0><0><0><0><0><0><0><0><7><7><0><0><7><7><7><0><7><7><7>
<0><0><0><0><0><0><0><0><0><0><0><0><0><0><0><0><0><0><0><0><0><0><0><0><0><0><0><0><0><0><0><0><0><0><0>
<0><0><0><0><0><0><0><0><0><0><0><0><0><0><0><0><0><0><0><0><0><0><0><0><0><0><0><0><0><0><0><0><0><0><0>
<0><0><0><0><0><0><0><0><0><0><0><0><0><0><0><0><0><0><0><0><0><0><0><0><0><0><0><0><0><0><0><0><0><0><0>
<0><0><0><0><0><0><0><0><0><0><0><0><0><0><0><0><0><0><0><0><0><0><0><0><0><0><0><0><0><0><0><0><0><0><0>
<0><0><0><0><0><0><0><0><0><0><0><0><0><0><0><0><0><0><0><0><0><0><0><0><0><0><0><0><0><0><0><0><0><0><0>
<0><0><0><0><0><0><0><0><0><0><0><0><0><0><0><0><0><0><0><0><0><0><0><0><0><0><0><0><0><0><0><0><0><0><0>
<0><0><0><0><0><0><0><0><0><0><0><0><0><0><0><0><0><0><0><0><0><0><0><0><0><0><0><0><0><0><0><0><0><0><0>
<0><0><0><0><0><0><0><0><0><0><0><0><0><0><0><0><0><0><0><0><0><0><0><0><0><0><0><0><0><0><0><0><0><0><0>
<0><0><0><0><0><0><0><0><0><0><0><0><0><0><0><0><0><0><0><0><0><0><0><0><0><0><0><0><0><0><0><0><0><0><0>
<0><0><0><0><0><0><0><0><0><0><0><0><0><0><0><0><0><0><0><0><0><0><0><0><0><0><0><0><0><0><0><0><0><0><0>
<1><1><1><1><1><1><1><1><1><1><1><1><1><1><1><1><1><1><1><1><1><1><1><1><2><2><2><2><2><2><0><0><0><0><0>
<6><6><6><6><6><6><6><6><6><6><6><6><6><6><6><6><6><6><6><6><6><6><6><6><2><2><2><2><2><2><0><0><0><0><0>
<0><0><0><0><0><0><0><0><0><0><0><0><0><0><0><0><0><0><0><0><0><0><0><0><0><0><0><0><0><0><0><0><0><0><0>
<0><0><0><0><0><0><0><0><0><0><0><0><0><0><0><0><0><0><0><0><0><0><0><0><0><0><0><0><0><0><0><0><0><0><0>
<0><0><0><0><0><0><0><0><0><0><0><0><0><0><0><0><0><0><0><0><0><0><0><0><0><0><0><0><0><0><0><0><0><0><0>
<0><0><0><0><0><0><0><0><0><0><0><0><0><0><0><0><0><0><0><0><0><0><0><0><0><0><0><0><0><0><0><0><0><0><0>
<!bg=1bee>